F 139,99,58
C 171,154,137

NO ./assets/nova/north.xpm
SO ./assets/nova/south.xpm
WE ./assets/nova/west.xpm
EA ./assets/nova/east.xpm

        11111111111  
        10000000001  
        10000000001  
        10000003001  
        10000000001  
        10000S00001  
        10000000001  
        10000000001  
        11110000001  
        10010001001  
        10000000001  
        11111211111  
        10000010001  
        10000010001  
        10000012111  
        10000000001  
        10000000001  
        10030000001  
        10000000001  
        10000000001  
        10000000001  
        10000000001  
        10000000001  
        10000000001  
        11110001111  
        10000000001  
        10003030001  
        11111211111  
        10000000001  
        10000000001  
        10000000001  
        13333033331  
        13333033331  
        13333033331  
        13333033331  
        13333033331  
        13333033331  
        13333033331  
        13333033331  
        13333033331  
        13333033331  
        13333033331  
        13333033331  
        13333033331  
        13333033331  
        13333033331  
        13333033331  
        13333033331  
        13333033331  
        13333033331  
        13333033331  
        13333033331  
        13333033331  
        13333033331  
        13333033331  
        13333033331  
        13333033331  
        13333033331  
        13333033331  
        13333033331  
        13333033331  
        13333033331  
        13333033331  
        13333033331  
        13333033331  
        13333033331  
        13333033331  
        13333033331  
        13333033331  
        13333033331  
        13333033331  
        13333033331  
        13333033331  
        13333033331  
        13333033331  
        13333033331  
        13333033331  
        13333033331  
        13333033331  
        13333033331  
        13333033331  
        13333033331  
        13333033331  
        13333033331  
        13333033331  
        13333033331  
        10000000001  
        10000000001  
        11111111111