F 139,99,58
C 171,154,137

NO ./assets/nova/north.xpm
SO ./assets/nova/south.xpm
WE ./assets/nova/west.xpm
EA ./assets/nova/east.xpm

        11111111111
        11111S11111
        11111011111
        11111011111
        11111011111
        11111011111
        11111011111
        11111011111
        11111011111
        11111011111
        11111011111
        11111011111
        11111011111
        11111011111
        11111011111
        11111011111
        11111011111
        11111011111
        11111011111
        11111011111
        11111011111
        11111011111
        11111211111  
        10100000101
        10101010101
        10100000101
        10101010101
        10100000101
        10101010101
        10100000101
        10101010101
        10100000101
        10101010101
        10100000101
        10101010101
        10100000101
        10101010101
        10100000101
        10101010101
        10100000101
        10101010101
        11111211111
        11111011111
        11111011111
        11111011111
        11111011111
        11111011111
        11111011111
        11111011111
        11111011111
        11110001111
        11110001111
        11110001111
        11110001111
        11110001111
        11110001111
        11110001111
        11110001111
        11110001111
        11110001111
        11110001111
        11110001111
        11110001111
        11100000111
        11100000111
        11100000111
        11100000111
        11100000111
        11100000111
        11100000111
        11100000111
        11100000111
        11100000111
        11100000111
        11100000111
        11100000111
        11111211111
        11111111111
