F 139,99,58
C 171,154,137

NO ./assets/nova/north.xpm
SO ./assets/nova/south.xpm
WE ./assets/nova/west.xpm
EA ./assets/nova/east.xpm


1111111111111111111
1001001001001001001
1301001001001001001
1001001001001001001
1001101000001001001
13002030030N0000001
1001011111111101001
1111210000000121111
1000000101010000001
1111111111111111111
