F 139,99,58
C 171,154,137

NO ./assets/nova/north.xpm
SO ./assets/nova/south.xpm
WE ./assets/nova/west.xpm
EA ./assets/nova/east.xpm


1111111111111111111
1001001001001001001
1001001001001001001
1001001E01001001001
1001001000001001001
1000000003000000001
1000011111111000001
1111200000000121111
1000000101010000001
1111111111111111111
