F 139,99,58
C 171,154,137

NO ./assets/nova/north.xpm
SO ./assets/nova/south.xpm
WE ./assets/nova/west.xpm
EA ./assets/nova/east.xpm

                    111111111111
                   10000000000001
                   10333333333301
                   10333333333301
                   10333333333301
 11111111111111111110333333333301
100000000000000000020000000000001
101111011110111101010333333333301
101001010010100101010333333333301
101001010010100101010333333333301
101101110011100111010000000000001
100000000000000000010000000000001
10111111111111111101111111111111
12100000000000000101
10101111111111110101
10101000000000010101
10101011111111010101
10101010000001010101
10101010111101012101
10000010100101000001
11111010101101111111
10001010100001000001
12111011111101111121
10N00000000000000001
 111111111111111111