F 139,99,58
C 171,154,137

NO ./assets/nova/north.xpm
SO ./assets/nova/south.xpm
WE ./assets/nova/west.xpm
EA ./assets/nova/east.xpm

11111111111
10000000001
10100000101
10000003001
10000000001
10000N00001
10000000001
10000000001
10000000001
10010001001
10000000001
11111211111
10000010001
10000010001
10000012111
10000000001
10000000001
10030000001
10000000001
11111111111
