11111111111
10001000001
10001000001
10001000001
10001000001
10111121111
10100000011
10100000011
10100011111
10100000011
10200000011
10100000021
10100000011
10100100011
10100100011
10100101111
10111121001
10111100001
10000000001
11111111111