F 139,99,58
C 171,154,137

NO ./assets/nova/north.xpm
SO ./assets/nova/south.xpm
WE ./assets/nova/west.xpm
EA ./assets/nova/east.xpm

11111111111
10000000001
13333033331
13333033331
13333033331
13333033331
13333033331
13333033331
13333033331
13333033331
13333033331
13333033331
13333033331
13333033331
10000000001
11111011111
11111211111
11111011111
10000000001
10100000101
10000000001
13333033331
13333033331
13333033331
13333033331
13333033331
13333033331
13333033331
13333033331
13333033331
13333033331
10000000001
11111011111
11111011111
11111011111
10000000001
10010001001
10000000001
11111011111
11111211111
11111010001
10001010001
10301010301
10001010001
11121012111
11101010111
10000000001
10000000001
10000000001
10010N01001
111 111 111
